1111111111111111111111
1000000000000000000001
1000000000000000000001
1000000000000000000001
1111111111111111000111
1000000000001000000001
1111100000111000000001
1111111111111000000001
1000000000000000000001
1000000000000000000001
1000000000000000000001
1111100011111111111111
1000000000000000200001
1000000000000000200001
1000000000000000200001
1111111111111111111111