11111111111111111111
10001000000000002001
10000000000000002001
10000000000000002001
11111000000000002001
10001000000000002001
10001000000000001111
10001000000000001001
11111000000000001001
10001111111111111001
10000010001000001001
10000010000000000001
10000000000000000001
10000010000000000001
11111111111111111111