111111111111111111111111111111
100000011111111100000000000001
100000001111111000000000000001
100000000002000000000000000001
100000000002000000000000000001
100000000002000000000000000001
111111111111111222111111100001
111000000000000000111111100001
111000000000000000111111100001
111000000000000000111111100001
111111111111111111111111100001
100000000000000100000000000001
110000000000000000000000000001
111111000000000100000000000001
111111111111111111111111111111