11111111111111111111111
10000001111111110000001
10000000111111100000001
10000000000200000000001
10000000000200000000001
10000000000200000000001
11111111111111111100001
11111111111111111100001
11111111111111111100001
11111111111111111100001
11111111111111111100001
10000000000000010000001
11000000000000000000001
11111100000000010000001
11111111111111111111111