111111111111111111111111111111
100020000000000000000000000001
100020000000000000000000000001
100020000000000000000000000001
111111111111111111000000000001
100000000000010001111111110001
100000000000000001000000000001
100000000000000001000000000001
100000000000000001000000000001
111111111111111111111111100011
100000100000000000000010000011
100000100000000000000000000111
100000100000000000000000001111
100000100000000000000000011111
111111111111111111111111111111