111111111111111111111111111111
100000010000000000000020000001
100000000000000000000020000001
100000000000000000000020000001
111111110000000000000020000001
100000010000000000000020000001
100000010000000000000011111111
100000010000000000000010000001
111111110000000000000010000001
100000011111111111111110000001
100000010001000000000010000001
100000010000000000000000000001
100000000000000000000000000001
100000010000000000000000000001
111111111111111111111111111111