111111111111111111111111111111
100000000000000000000000010001
100000000000000000000000010001
100000000000000000000000000001
100000000011111111111100000001
100000000010000000000110000001
100001100010000000000111110001
111111111111111111111111110001
100020000000000000000000010001
100020000000000000000000010001
100020000000000000000000000001
100020000000000000000000000001
100020000000000000000000000001
100020000000000000000000000001
111111111111111111111111111111