111111111111111111111111
110000000000000000000001
110000000000000000000001
110000000000000000000011
110000000000000000000111
110000000022221111111111
100001111100000000001001
100011110000000000001001
100000010000000000001111
111100011111111100000001
111111111111111110000011
111111111000002000000011
111111111000002000000011
111111111000002000000011
111111111111111111111111