11111111111111111111111
10020000000000000000001
10020000000000000000001
10020000000000000000001
10020000000000000000001
10020000000000000000001
11111111100000001111111
11111111111000111111111
10000000010000111111111
10000000000001111111111
10000000000011111111111
10000000000111111111111
11111111111111111111111