111111111111111111111111111111
100000000000000000000000000001
100000000000000000000000000001
100000000000000000000000000001
100000000000000000000000000001
111111100000000000000000000001
111111110000000000000000000001
111111111111111111110000000001
111111111111111111111000000001
100000000000000000000000000011
100000000000000000000000000111
100000000000000000000000001111
100000000000000000001100011111
100000000000000000011111111111
111111111111111111111111111111