111111111111111111111111111111
100000000000000000000000200001
100000000000000000000000200001
100000000000000000000000200001
111111111111111111110001111111
100000000000000010000000000001
110000000000001110000000000001
111111111111111110000000000001
100000000000000000000000000001
100000000000000000000000000001
100000000000000000000000000001
111110001111111111111111111111
100000000000000000000020000001
100000000000000000000020000001
100000000000000000000020000001
111111111111111111111111111111