111111111111111111111111111111
100000000000000000000000000001
100000000000000000000000000001
100000000000000000000000001111
111111111100000000000000000001
100000000110000000000000000001
100000000111000000122222000001
100000000111100000100000111111
111111111111111111100000100001
100000000000000000000000100001
100000000000000000000000100001
100000000000000000000000100001
100000000000000000000000100001
100000000000000000000000100001
111111111111111111111111111111