111111111111111111111111111111
110000000000000000000000000001
110000000000000000000000110001
110000000000000000000000000011
110000000000000000000000000111
110000000022222211111111111111
100001111100000000000000001001
100011110000000000000000001001
100000010000000000000000001111
111100011111111111110000000001
111111111111111111111000000011
100011111000000000020000000011
100011111000000000020000000011
111111111000000000020000000011
111111111111111111111111111111