11111111111111111111111
10000000000000000010001
10000000000000000010001
10000000000000000000001
10000000111111100000001
10000110000000000000001
11111111111111111112221
10000000000000000000001
10000000000000000000001
10000000000000000000001
10000000000000000000001
10000000001000000000001
11111111111111111111111