111111111111111111
100000000000000001
100000000000000001
100000000000000001
100000000000000001
111111100000000001
111111110000000001
111111111110000001
111111111111000001
100000000000000011
100000000000000011
100000000000000011
100000000001100011
100000000011111111
111111111111111111