1111111111111111111111111111111111
1000000100000000000000200000000001
1000000000000000000000200000000001
1000000000000000000000200000000001
1111111100000000000000200000000001
1000000100000000000000200000000001
1000000100000000000000111111111111
1000000100000000000000100000000001
1111111100000000000000100000000001
1000000111111111111111100000000001
1000000100010000000000100000000001
1000000100000000000000000000000001
1000000000000000000000000000000001
1000000100000000000000000000000001
1111111111111111111111111111111111