11111111111111111111111
10000000000000000010001
10000000000000000010001
10000000000000000000001
10000000111111110000001
10000110000000000000001
11111111111111111110001
10002000000000000010001
10002000000000000000001
10002000000000000000001
10002000000000000000001
10002000000000000000001
11111111111111111111111