1111111111111111111111111
1000000000000000000000001
1000000000000000000000001
1000000000000000000001111
1111111110000000000000001
1000000011000000000000001
1000000011100122222000001
1000000011110100000111111
1111111111111100000100001
1000000000000000000100001
1000000000000000000100001
1000000000000000000100001
1000000000000000000100001
1000000000000000000100001
1111111111111111111111111